NAR = "countries/NAR.txt"
HRO = "countries/HRO.txt"
LIN = "countries/LIN.txt"
LIP = "countries/LIP.txt"
ANU = "countries/ANU.txt"
BAW = "countries/BAW.txt"
OND = "countries/OND.txt"
MRH = "countries/MRH.txt"
WDB = "countries/WDB.txt"
ARP = "countries/ARP.txt"
VEY = "countries/VEY.txt"
TLP = "countries/TLP.txt"
CEY = "countries/CEY.txt"
FLI = "countries/FLI.txt"
RFU = "countries/RFU.txt"
ARB = "countries/ARB.txt"
BRO = "countries/BRO.txt"
HAV = "countries/HAV.txt"
BRC = "countries/BRC.txt"
ELR = "countries/ELR.txt"
VIN = "countries/VIN.txt"
KAR = "countries/KAR.txt"
CRM = "countries/CRM.txt"
GIL = "countries/GIL.txt"
TNG = "countries/TNG.txt"
VLK = "countries/VLK.txt"
WLD = "countries/WLD.txt"
SNC = "countries/SNC.txt"
VLE = "countries/VLE.txt"
TRG = "countries/TRG.txt"
VND = "countries/VND.txt"
STK = "countries/STK.txt"
MLT = "countries/MLT.txt"
AGE = "countries/AGE.txt"
BEL = "countries/BEL.txt"
TRU = "countries/TRU.txt"
NIR = "countries/NIR.txt"
VRO = "countries/VRO.txt"
TLW = "countries/TLW.txt"
MSC = "countries/MSC.txt"
SLO = "countries/SLO.txt"
NON = "countries/NON.txt"
ELE = "countries/ELE.txt"
WEN = "countries/WEN.txt"
NIN = "countries/NIN.txt"
MRA = "countries/MRA.txt"
PIU = "countries/PIU.txt"
RLL = "countries/RLL.txt"
ANG = "countries/ANG.txt"
SER = "countries/SER.txt"
SDO = "countries/SDO.txt"
FAN = "countries/FAN.txt"
KEM = "countries/KEM.txt"
VAH = "countries/VAH.txt"
BDA = "countries/BDA.txt"
NAG = "countries/NAG.txt"
VIL = "countries/VIL.txt"
ABA = "countries/ABA.txt"
CRD = "countries/CRD.txt"
NRA = "countries/NRA.txt"
VNU = "countries/VNU.txt"
CUL = "countries/CUL.txt"
SDL = "countries/SDL.txt"
FNC = "countries/FNC.txt"
NRN = "countries/NRN.txt"
NEY = "countries/NEY.txt"
WNY = "countries/WNY.txt"
MAC = "countries/MAC.txt"
HME = "countries/HME.txt"
MLD = "countries/MLD.txt"
NEN = "countries/NEN.txt"
WEL = "countries/WEL.txt"
ATA = "countries/ATA.txt"
BAA = "countries/BAA.txt"
SKD = "countries/SKD.txt"
BLO = "countries/BLO.txt"
FLA = "countries/FLA.txt"
FRE = "countries/FRE.txt"
FRS = "countries/FRS.txt"
SDW = "countries/SDW.txt"
SPR = "countries/SPR.txt"
STR = "countries/STR.txt"
SUN = "countries/SUN.txt"
NL0 = "countries/NL0.txt"
NL1 = "countries/NL1.txt"
NL2 = "countries/NL2.txt"
NL3 = "countries/NL3.txt"
NL4 = "countries/NL4.txt"
NL5 = "countries/NL5.txt"
NL6 = "countries/NL6.txt"
NL7 = "countries/NL7.txt"
GHO = "countries/GHO.txt"
DRH = "countries/DRH.txt"
BLD = "countries/BLD.txt"
SHB = "countries/SHB.txt"
CIN = "countries/CIN.txt"
THO = "countries/THO.txt"
WIL = "countries/WIL.txt"
BLM = "countries/BLM.txt"
SHF = "countries/SHF.txt"
CRO = "countries/CRO.txt"
DUN = "countries/DUN.txt"
RIV = "countries/RIV.txt"
VER = "countries/VER.txt"
ORC = "countries/ORC.txt"
HEL = "countries/HEL.txt"
RIM = "countries/RIM.txt"
MEI = "countries/MEI.txt"
NEQ = "countries/NEQ.txt"
CRI = "countries/CRI.txt"
ALA = "countries/ALA.txt"
TOR = "countries/TOR.txt"
PAA = "countries/PAA.txt"
TEN = "countries/TEN.txt"
KHN = "countries/KHN.txt"
SEN = "countries/SEN.txt"
BRU = "countries/BRU.txt"
FRV = "countries/FRV.txt"
BLA = "countries/BLA.txt"
THR = "countries/THR.txt"
SIN = "countries/SIN.txt"
SA1 = "countries/SA1.txt"
SA2 = "countries/SA2.txt"
SA3 = "countries/SA3.txt"
SA4 = "countries/SA4.txt"
SA5 = "countries/SA5.txt"
SA6 = "countries/SA6.txt"
SA7 = "countries/SA7.txt"
SA8 = "countries/SA8.txt"
SA9 = "countries/SA9.txt"
SB0 = "countries/SB0.txt"
SB1 = "countries/SB1.txt"
SB2 = "countries/SB2.txt"
SB3 = "countries/SB3.txt"
SB4 = "countries/SB4.txt"
SB5 = "countries/SB5.txt"
SB6 = "countries/SB6.txt"
SB7 = "countries/SB7.txt"
SB8 = "countries/SB8.txt"
SB9 = "countries/SB9.txt"
SC0 = "countries/SC0.txt"
SC1 = "countries/SC1.txt"
SC2 = "countries/SC2.txt"
SC3 = "countries/SC3.txt"
SC4 = "countries/SC4.txt"
SC5 = "countries/SC5.txt"
SC6 = "countries/SC6.txt"
SC7 = "countries/SC7.txt"
SC8 = "countries/SC8.txt"
SC9 = "countries/SC9.txt"
SD0 = "countries/SD0.txt"
VLT = "countries/VLT.txt"
BRA = "countries/BRA.txt"
SHV = "countries/SHV.txt"
GRH = "countries/GRH.txt"
LON = "countries/LON.txt"
ROO = "countries/ROO.txt"
VRA = "countries/VRA.txt"
VUL = "countries/VUL.txt"
GUS = "countries/GUS.txt"
DRU = "countries/DRU.txt"
BAR = "countries/BAR.txt"
GLD = "countries/GLD.txt"
BLT = "countries/BLT.txt"
JAT = "countries/JAT.txt"
TRH = "countries/TRH.txt"
DBU = "countries/DBU.txt"
HUN = "countries/HUN.txt"
KEF = "countries/KEF.txt"
KET = "countries/KET.txt"
NET = "countries/NET.txt"
HDE = "countries/HDE.txt"
TAL = "countries/TAL.txt"
HOR = "countries/HOR.txt"
TOT = "countries/TOT.txt"
SEW = "countries/SEW.txt"
SIL = "countries/SIL.txt"
YOL = "countries/YOL.txt"
MON = "countries/MON.txt"
TGN = "countries/TGN.txt"
TG0 = "countries/TG0.txt"
TG1 = "countries/TG1.txt"
TG2 = "countries/TG2.txt"
TG3 = "countries/TG3.txt"
TG4 = "countries/TG4.txt"
YAT = "countries/YAT.txt"
SAM = "countries/SAM.txt"
KAN = "countries/KAN.txt"